111111
1PT0C1
100011
1E00C1
111011
