1111111111111
1P000000000C1
10001110001C1
1E0000C0010C1
1111111111111
