11111111111111111111111111111111111111111111111111
1P000000000C000000000C00000000001111000000C0000001
10001110001C000000000000C0000000000000C00000C00001
1E0000C0010C00000000000000000000000000000000000001
10001110001C000000000000C0000000000000C00000C00001
10001110001C000000000000C0000000000000C00000C00001
10001110001C000000000000C0000000000000C00000C00001
10001110001C000000000000C0000000000000C00000C00001
10001110001C000000000000C0000000000000C00000C00001
10001110001C000000000000C0000000000000C00000C00001
10001110001C000000000000C0000000000000C00000C00001
11111111111111111111111111111111111111111111111111
