1111111
1000PE1
1110C01
1010001
1000001
1111111
1111111
1111111
1111111
1111111
